7   8   
00000000
0XXX0XX0
00000XX0
000X0XXF
000X0000
000X0000
S00X0000
